35 10
25 26 26 26 26 26 26 26 26 26 25 25 25 26 25 25 25 25 26 26 26 26 26 26 26 26 26 26 26 26 26 26 26 26 26
0 0 0 0 5 0 0 0 0 0 0 0 8 9 0 0 0 0 5 0 0 0 0 0 0 0 0 3 0 0 0 0 0 0 0
0 4 0 31 3 0 3 31 3 0 6 0 0 0 3 31 0 0 3 0 4 0 0 0 7 0 4 0 0 0 0 0 0 0 0
0 0 31 0 4 31 0 7 0 4 0 3 0 31 4 0 3 31 0 3 0 0 3 0 0 0 0 3 0 0 0 0 0 0 0
0 0 0 0 0 0 0 0 0 0 0 0 0 0 0 0 0 0 0 0 0 0 0 0 0 0 0 0 0 0 0 0 0 0 0
0 0 0 0 0 0 0 2 0 0 0 0 0 0 0 0 0 0 0 0 0 0 0 0 0 0 0 0 0 0 0 0 32 0 0
0 0 1 0 0 0 0 0 0 0 0 0 2 0 0 0 0 0 0 0 0 0 0 0 0 0 0 0 0 0 0 0 0 0 0
0 0 0 0 3 31 0 3 31 4 0 0 3 31 31 4 0 0 3 0 3 31 4 0 0 7 4 0 6 0 0 0 0 0 0
6 0 4 0 0 3 4 5 0 0 0 7 31 0 0 0 0 3 0 31 0 3 0 31 5 3 0 31 4 0 0 0 0 0 0
21 21 21 21 21 21 21 21 21 21 21 21 21 21 21 21 21 21 21 22 21 21 21 21 21 21 21 21 21 21 21 21 21 21 21