15 20
0 0 0 0 0 0 0 0 0 0 3 13 14 4 0
0 0 0 0 0 0 0 0 0 0 3 13 14 4 0
0 0 0 0 0 0 2 0 0 0 3 13 14 4 0
0 0 0 0 0 0 0 0 0 0 3 13 14 4 0
0 0 1 0 0 0 0 0 0 0 3 13 14 4 0
0 0 0 0 0 0 0 0 0 0 3 13 14 4 0
0 0 0 0 0 0 0 0 0 0 3 13 14 4 0
0 0 0 0 0 0 0 0 0 0 3 13 14 4 0
0 0 1 0 0 0 0 0 0 0 3 13 14 4 0
0 0 0 0 0 0 2 0 0 0 3 13 14 4 0
0 0 0 0 0 0 0 0 0 0 3 13 14 4 0
0 0 0 0 0 0 0 0 0 0 3 13 14 4 0
0 0 12 0 12 0 12 0 0 0 3 13 14 4 0
0 0 2 0 0 0 0 0 0 0 0 0 0 0 0
0 0 12 0 12 12 0 0 2 0 3 13 14 4 0
0 0 0 0 0 0 12 0 0 0 3 13 14 4 0
0 0 0 12 0 0 12 0 0 0 3 13 14 4 0
0 2 0 10 0 0 10 0 0 12 3 13 14 4 0
0 0 0 9 0 0 9 0 0 1 3 13 14 4 0
0 0 0 0 0 0 0 0 0 0 3 13 14 4 0