20 20
24 24 24 24 24 24 24 25 9 10 26 24 24 24 24 24 24 24 24 24
0 0 13 14 0 0 4 7 9 10 8 0 0 0 0 5 0 0 0 0
0 0 5 0 0 0 3 7 9 10 8 13 14 4 6 0 0 6 2 1
0 0 5 0 6 0 0 7 9 10 8 5 0 3 0 0 0 0 4 6
0 5 0 0 6 0 4 7 9 10 8 4 0 0 0 0 0 0 3 0
5 0 0 6 0 0 3 7 9 10 8 3 0 0 0 24 24 0 0 6
5 0 0 0 5 0 6 7 9 10 8 0 0 0 6 0 0 0 5 0
4 5 2 5 0 0 0 7 12 11 8 0 0 6 0 0 0 0 4 6
3 4 0 0 6 0 6 7 9 10 8 1 6 4 24 24 0 0 3 0
4 3 0 0 6 0 0 7 9 10 8 0 0 3 0 0 0 0 0 6
3 5 0 0 0 6 4 7 9 10 8 0 13 14 0 0 0 0 4 24
5 0 0 0 0 5 3 4 5 4 24 24 4 0 0 0 0 0 3 0
5 0 4 4 5 0 0 3 24 1 0 0 3 0 0 0 4 0 24 24
5 0 3 3 0 1 0 0 6 24 0 24 24 0 0 0 3 24 24 0
5 4 0 0 0 6 0 7 9 10 26 24 5 0 0 6 0 0 0 0
5 0 0 6 6 0 0 7 9 10 8 5 0 0 6 4 15 16 17 0
5 0 6 0 0 0 0 7 9 10 8 2 0 6 0 3 18 19 20 0
5 0 0 6 0 13 14 7 9 10 8 0 0 0 6 0 21 22 23 0
0 0 0 6 4 0 0 7 9 10 8 0 4 0 0 0 0 0 1 0
0 0 6 0 3 24 24 25 9 10 26 24 3 24 0 0 2 0 0 0