35 8
25 26 26 26 26 26 26 26 26 26 26 26 26 26 25 25 25 25 26 26 26 26 26 26 26 26 26 26 26 26 26 26 26 26 26
0 0 0 0 0 0 0 1 1 0 0 0 0 0 0 1 2 0 0 0 0 0 0 0 0 0 0 0 0 1 0 0 0 0 0
1 1 1 14 15 2 1 1 4 5 3 8 13 1 1 1 1 8 9 1 1 1 1 1 1 1 1 0 4 5 1 1 1 1 0
14 9 1 1 1 1 8 13 1 1 1 1 1 1 1 1 1 1 1 8 9 1 1 1 1 3 1 0 0 1 1 1 1 1 0
14 9 16 0 0 0 0 1 1 0 2 0 8 9 0 14 13 0 0 0 0 0 0 0 0 0 0 0 0 0 0 0 0 0 0
12 15 0 0 0 0 3 1 1 1 1 0 0 0 0 6 7 0 0 0 0 2 0 0 0 0 0 0 0 0 0 0 0 0 0
1 1 1 14 9 1 8 9 1 1 1 1 1 12 13 1 1 1 1 1 14 15 1 1 1 1 1 0 0 3 1 1 1 1 0
20 21 21 22 21 21 21 22 21 22 21 21 21 21 22 21 22 21 21 21 22 21 21 21 21 21 22 21 22 21 21 22 21 21 21