35 10
25 26 26 26 26 26 26 26 26 26 25 25 25 26 25 25 25 25 26 26 26 26 26 26 26 26 26 26 26 26 26 26 26 26 26
12 17 0 0 5 0 0 0 0 0 18 17 8 9 0 16 17 0 5 0 0 0 0 0 0 0 0 0 0 0 0 6 0 0 0
0 4 0 0 0 12 13 12 17 0 6 0 0 12 13 0 0 12 17 0 4 0 0 0 7 0 4 0 0 0 0 0 4 0 0
0 0 0 16 17 0 0 7 0 18 17 0 0 0 4 0 0 0 0 0 0 0 0 0 0 0 0 0 0 0 0 0 0 0 0
0 0 0 0 0 12 17 0 0 0 0 0 12 19 0 0 0 0 0 0 0 0 0 0 0 0 0 0 0 7 0 0 0 0 0
0 0 0 0 0 0 12 13 0 16 13 0 0 0 0 0 0 0 5 0 0 7 0 0 0 0 4 0 0 0 0 0 0 1 0
4 38 39 0 0 0 0 0 0 0 0 0 4 0 12 17 0 4 18 19 0 0 0 0 0 0 0 0 0 0 0 0 0 0 0
0 0 12 19 16 17 0 0 12 13 0 0 18 13 0 0 0 0 0 0 0 0 4 0 0 7 0 0 6 0 0 0 7 0 0
0 0 0 12 17 0 0 5 0 0 0 7 0 0 0 12 13 0 0 0 0 0 0 0 5 0 0 0 0 10 11 0 0 0 0
21 21 21 21 21 21 21 21 21 21 21 21 21 21 21 21 21 21 21 21 21 21 21 21 21 21 21 21 21 21 21 21 21 21 21