30 20
0 5 2 3 4 2 3 4 2 3 4 2 3 4 2 3 4 89 2 3 4 5 2 3 4 5 89 5 5 6
7 52 53 10 11 9 10 11 9 10 11 52 53 52 53 52 53 88 52 53 11 52 53 10 52 53 88 52 53 13
14 54 55 19 19 19 19 19 19 19 19 54 55 54 55 54 55 81 54 55 19 54 55 19 54 55 81 54 55 20
27 28 28 22 28 22 28 22 28 22 28 28 28 28 28 28 28 79 28 28 28 28 28 28 28 40 79 42 42 26
27 22 28 22 28 22 28 22 28 22 28 22 28 22 22 22 22 79 22 56 60 61 62 63 22 41 79 43 43 26
27 22 28 22 28 22 28 22 28 79 28 22 28 22 22 22 22 79 22 57 70 71 72 64 22 22 79 22 22 26
27 22 28 22 56 60 61 62 63 79 34 35 36 22 34 35 36 79 22 58 73 74 75 65 22 22 79 22 22 26
27 22 22 22 57 70 71 72 64 79 37 38 39 22 37 38 39 79 22 59 67 67 67 66 22 22 79 22 22 26
27 22 28 22 58 73 74 75 65 79 28 22 28 22 22 22 22 79 22 22 22 22 22 22 22 22 79 22 22 26
27 22 28 22 59 67 67 67 66 79 28 22 28 22 22 22 40 86 80 80 80 28 28 28 80 80 78 22 22 26
27 22 28 22 28 22 28 22 28 79 28 22 28 22 22 22 41 79 41 41 41 41 22 41 41 41 41 22 22 26
27 22 28 22 28 22 28 22 28 79 28 22 22 22 22 22 40 79 22 22 28 28 28 28 22 22 22 22 22 26
27 22 28 22 56 60 61 62 63 86 80 80 80 84 22 22 41 86 80 80 80 28 22 22 80 80 84 22 22 26
27 22 28 22 57 70 71 72 64 79 16 17 18 79 22 22 40 79 52 53 22 22 22 22 52 53 79 22 22 26
27 22 28 22 58 73 74 75 65 79 31 32 33 79 22 22 41 79 54 55 22 22 22 22 54 55 79 22 22 26
27 22 28 22 59 68 68 68 66 79 28 22 22 79 22 22 40 79 42 42 56 60 61 62 63 40 79 22 22 26
27 22 28 22 28 22 28 22 28 79 28 22 22 79 22 22 41 79 43 43 57 70 71 72 64 41 79 22 22 26
27 22 28 22 28 22 28 22 28 22 28 28 22 79 22 22 22 22 22 22 58 73 74 75 65 40 79 22 22 26
27 22 28 22 28 22 28 22 28 22 28 28 22 79 22 22 22 22 22 22 59 67 67 67 66 41 79 22 22 26
29 30 30 30 30 30 30 30 30 30 30 30 30 85 30 30 30 30 30 30 30 30 30 30 30 30 85 30 30 76