30 20
0 5 5 5 5 5 5 5 5 5 5 5 5 5 2 3 4 84 2 3 4 5 2 3 4 85 85 5 5 6
7 12 12 12 12 12 12 12 12 12 12 12 12 12 9 10 11 83 9 10 11 12 9 10 11 12 83 52 53 13
14 19 19 19 19 19 19 19 19 19 19 19 19 19 19 19 19 81 19 19 19 19 19 19 19 19 81 54 55 20
27 22 28 22 28 22 28 22 28 22 28 22 28 22 22 22 22 79 22 22 22 22 22 22 22 22 79 22 41 26
27 22 28 22 28 22 28 22 28 22 28 22 28 22 22 22 22 79 22 56 60 61 62 63 22 22 79 22 42 26
27 22 28 22 28 22 28 22 28 22 28 22 28 22 22 22 22 79 22 57 70 71 72 65 22 22 79 22 22 26
27 22 28 22 28 22 28 22 28 22 22 22 22 22 22 22 22 79 22 58 73 74 73 64 22 22 79 22 22 26
27 22 22 22 22 22 22 22 22 22 22 22 22 22 22 22 22 79 22 67 67 67 67 66 22 22 79 22 22 26
27 22 28 22 28 22 28 22 28 22 28 22 28 22 22 22 22 79 22 22 22 22 22 22 22 22 79 22 22 26
27 22 28 22 28 22 28 22 28 22 28 22 28 22 22 22 22 79 22 22 22 22 22 22 22 22 79 22 22 26
27 22 28 22 28 22 28 22 28 22 28 22 28 22 22 22 22 82 80 80 80 80 22 22 80 80 78 22 22 26
27 22 28 22 28 22 28 22 28 22 28 22 22 22 22 22 22 22 22 22 22 22 22 22 22 22 22 22 22 26
27 22 28 22 28 22 28 22 28 22 28 22 28 22 22 22 22 22 22 22 22 22 22 22 22 22 79 22 22 26
27 22 28 22 28 22 28 22 28 22 28 22 22 22 22 22 22 22 22 22 22 22 22 22 22 22 79 22 22 26
27 22 28 22 28 22 28 22 28 22 28 22 22 22 22 22 22 22 22 22 22 22 22 22 22 22 79 22 22 26
27 22 28 22 28 22 28 22 28 22 28 22 22 22 22 22 22 22 22 22 22 22 22 22 22 22 79 22 22 26
27 22 28 22 28 22 28 22 28 22 28 22 22 22 22 22 22 22 22 22 22 22 22 22 22 22 79 22 22 26
27 22 28 22 28 22 28 22 28 22 28 28 22 22 22 22 22 22 22 22 22 22 22 22 22 22 79 22 22 26
27 22 28 22 28 22 28 22 28 22 28 28 22 22 22 22 22 22 22 22 22 22 22 22 22 22 79 22 22 26
29 30 30 30 30 30 30 30 30 30 30 30 30 30 30 30 30 30 30 30 30 30 30 30 30 30 30 30 30 76