24 30
0 23 22 24 0 0 12 11 10 0 0 0 0 0 0 0 0 0 0 0 0 0 0 0
23 21 21 25 24 12 11 10 11 12 0 18 0 0 13 0 0 0 20 0 0 10 0 0
0 21 27 21 0 10 11 12 10 12 0 0 0 17 0 0 18 0 0 0 10 12 12 0
5 19 19 2 19 7 15 9 0 0 0 0 0 0 0 0 0 0 0 11 11 10 12 12
5 19 19 19 19 0 0 16 0 1 1 1 1 1 1 0 0 0 0 0 7 9 0 0
0 13 13 1 1 0 0 0 0 1 10 11 10 0 1 0 17 0 0 0 0 6 8 0
0 0 13 0 1 1 1 1 1 1 11 10 12 0 1 0 0 0 0 17 0 16 0 0
0 0 0 0 0 0 0 0 0 1 0 9 8 0 1 0 0 0 0 0 0 5 0 0
0 0 0 0 20 0 0 17 0 1 0 16 0 0 1 1 1 1 1 1 1 1 0 0
0 0 0 0 0 0 0 0 0 1 0 0 0 0 0 0 0 0 0 0 0 0 0 0
0 0 13 0 0 0 0 0 0 1 0 0 0 0 0 17 0 0 0 0 0 17 0 0
0 0 13 13 0 0 14 0 0 1 0 0 0 18 0 0 0 0 0 18 0 0 0 0
0 0 0 0 0 0 0 0 0 1 0 0 0 0 0 0 0 0 0 0 0 0 0 0
0 5 0 0 0 0 0 0 0 1 0 0 18 0 0 0 20 0 0 13 13 0 0 20
0 0 0 0 3 3 0 1 1 1 0 0 0 0 0 0 0 0 0 0 0 0 0 0
0 17 18 0 0 0 0 1 0 0 0 0 14 0 0 0 0 0 0 18 0 0 0 0
0 0 0 0 0 0 0 1 0 0 0 0 0 0 0 0 0 0 0 0 0 0 0 0
0 0 0 0 0 1 1 1 0 0 23 24 0 3 3 0 0 0 0 0 0 0 0 0
0 5 0 0 1 1 0 0 0 23 22 22 24 0 0 0 17 0 10 12 11 0 0 18
0 0 0 0 1 0 0 0 23 22 22 22 22 24 0 0 0 12 12 10 10 11 0 0
0 17 18 0 1 0 0 23 21 21 21 21 21 21 24 0 0 11 11 12 11 12 0 0
0 0 0 0 1 0 0 0 21 26 21 25 21 21 0 0 0 7 15 9 0 0 0 0
0 0 0 0 1 14 14 2 21 21 27 21 21 21 14 14 0 0 0 9 8 0 0 0
0 14 0 0 1 1 1 19 19 19 19 19 19 0 0 0 0 0 0 16 0 0 0 0
0 14 14 13 13 13 13 19 19 19 19 19 19 13 13 13 13 0 0 0 0 0 0 0
0 0 0 20 20 20 3 3 3 3 3 3 3 3 20 20 20 0 0 0 0 5 0 0
0 0 0 0 0 20 20 20 20 20 20 20 20 20 20 0 0 0 0 3 0 0 17 0
0 0 0 0 0 0 0 0 0 0 0 0 0 0 0 0 0 0 3 0 0 0 0 0
4 4 4 4 4 4 4 4 4 4 4 4 4 4 4 4 4 4 4 4 4 4 4 4
28 28 28 28 28 28 28 28 28 28 28 28 28 28 28 28 28 28 28 28 28 28 28 28